18,18,18,18,18,18,18,18,18,18
18,12,12,12,12,12,12,12,12,18
18,12,15,13,13,13,13,14,12,18
18,12,17,8,7,7,9,16,12,18
18,12,17,5,1,1,6,16,12,18
18,12,17,5,1,1,6,16,12,18
18,12,17,3,2,2,4,16,12,18
18,12,21,19,19,19,19,19,12,18
18,12,12,12,12,12,12,12,12,18
18,18,18,18,18,18,18,18,18,18